#####
###S#
##  #
###E#
#####
